//MAP CONVERTED BY dmm2tgm.py THIS HEADER COMMENT PREVENTS RECONVERSION, DO NOT REMOVE
"a" = (
/turf/unsimulated/wall/planetary/normal,
/area/planets/Geminus/outdoor/vr/forest)
"b" = (
/turf/simulated/mineral/impassable,
/area/planets/Geminus/outdoor/vr/forest)
"c" = (
/turf/simulated/floor/snow,
/area/planets/Geminus/outdoor/vr/forest)
"d" = (
/obj/structure/flora/tree/dead,
/turf/simulated/floor/snow,
/area/planets/Geminus/outdoor/vr/forest)
"e" = (
/obj/structure/flora/tree/jungle_small,
/turf/simulated/floor/snow,
/area/planets/Geminus/outdoor/vr/forest)
"f" = (
/obj/structure/flora/grass/brown,
/turf/simulated/floor/snow,
/area/planets/Geminus/outdoor/vr/forest)
"g" = (
/obj/structure/closet/statue,
/turf/simulated/floor/snow,
/area/planets/Geminus/outdoor/vr/forest)
"h" = (
/obj/structure/flora/tree/jungle,
/turf/simulated/floor/snow,
/area/planets/Geminus/outdoor/vr/forest)
"i" = (
/obj/item/weapon/nullrod,
/turf/simulated/floor/snow,
/area/planets/Geminus/outdoor/vr/forest)
"j" = (
/obj/structure/bonfire/permanent,
/turf/simulated/floor/snow,
/area/planets/Geminus/outdoor/vr/forest)
"k" = (
/obj/structure/flora/rock,
/turf/simulated/floor/snow,
/area/planets/Geminus/outdoor/vr/forest)
"l" = (
/obj/structure/flora/grass/green,
/turf/simulated/floor/snow,
/area/planets/Geminus/outdoor/vr/forest)
"m" = (
/obj/structure/loot_pile/VR/weapon,
/turf/simulated/floor/snow,
/area/planets/Geminus/outdoor/vr/forest)
"n" = (
/mob/living/simple_animal/hostile/statue{
	banishable = 1;
	view_range = 15
	},
/turf/simulated/floor/snow,
/area/planets/Geminus/outdoor/vr/forest)
"o" = (
/obj/structure/flora/grass/both,
/turf/simulated/floor/snow,
/area/planets/Geminus/outdoor/vr/forest)
"p" = (
/obj/effect/landmark/virtual_reality{
	name = "Bosnian Caves: 2324 - Remastered"
	},
/turf/simulated/floor/snow,
/area/planets/Geminus/outdoor/vr/forest)
"q" = (
/obj/structure/loot_pile/VR/firstaid,
/obj/structure/table/alien,
/turf/simulated/floor/snow,
/area/planets/Geminus/outdoor/vr/forest)
"r" = (
/obj/structure/table/alien,
/turf/simulated/floor/snow,
/area/planets/Geminus/outdoor/vr/forest)
"s" = (
/turf/unsimulated/wall/planetary/normal,
/area/planets/Geminus/outdoor/vr)
"t" = (
/obj/structure/loot_pile/VR/light,
/obj/structure/table/alien,
/turf/simulated/floor/snow,
/area/planets/Geminus/outdoor/vr/forest)
"u" = (
/turf/simulated/mineral,
/area/planets/Geminus/outdoor/vr)
"w" = (
/turf/simulated/mineral/floor,
/area/planets/Geminus/outdoor/vr)
"x" = (
/turf/simulated/floor/outdoors/grass,
/area/planets/Geminus/outdoor/vr)
"y" = (
/turf/simulated/floor/outdoors/grass/forest,
/area/planets/Geminus/outdoor/vr)
"z" = (
/turf/simulated/floor/outdoors/grass/nogrowth,
/area/planets/Geminus/outdoor/vr)
"B" = (
/obj/structure/loot_pile/VR/knife,
/turf/simulated/floor/outdoors/grass/nogrowth,
/area/planets/Geminus/outdoor/vr)
"C" = (
/obj/structure/loot_pile/VR/light,
/turf/simulated/floor/outdoors/grass/nogrowth,
/area/planets/Geminus/outdoor/vr)
"D" = (
/obj/effect/landmark/virtual_reality{
	name = "CaveCraft"
	},
/obj/structure/bed,
/turf/simulated/floor/outdoors/grass/nogrowth,
/area/planets/Geminus/outdoor/vr)
"E" = (
/obj/structure/bonfire/permanent,
/turf/simulated/floor/outdoors/grass/nogrowth,
/area/planets/Geminus/outdoor/vr)
"F" = (
/turf/simulated/floor/water,
/area/planets/Geminus/outdoor/vr)

(1,1,1) = {"
s
s
s
s
s
s
s
s
s
s
s
s
s
s
s
s
s
s
s
s
s
s
s
s
s
s
s
s
s
s
s
s
s
s
s
a
a
a
a
a
a
a
a
a
a
a
a
a
a
a
a
a
a
a
a
a
a
a
a
a
a
a
a
a
a
a
a
a
a
a
"}
(2,1,1) = {"
s
u
u
u
u
u
u
u
u
u
u
u
u
u
u
u
u
u
u
u
u
u
u
u
u
u
u
u
u
u
u
u
u
u
u
a
b
b
b
b
b
b
b
b
b
b
b
b
b
b
b
b
b
b
b
b
b
b
b
b
b
b
b
b
b
b
b
b
b
a
"}
(3,1,1) = {"
s
u
u
u
u
u
u
u
u
u
u
u
u
u
u
u
u
u
u
u
u
u
u
u
u
u
u
u
u
u
u
u
u
u
u
a
b
b
c
h
b
b
b
b
b
b
b
b
b
b
b
b
b
b
b
b
c
e
b
b
b
b
b
b
b
b
b
b
b
a
"}
(4,1,1) = {"
s
u
u
u
u
u
u
u
u
u
x
x
x
x
x
x
x
x
x
u
u
u
u
y
y
F
F
F
F
F
F
F
F
u
u
a
b
b
c
c
b
b
b
b
b
b
b
b
b
b
b
b
b
c
c
c
c
c
c
b
b
b
b
b
b
b
b
b
b
a
"}
(5,1,1) = {"
s
u
u
u
u
u
u
w
u
u
x
x
x
x
x
x
x
x
x
x
x
x
u
y
y
y
F
F
F
F
F
F
F
F
u
a
b
b
c
i
c
b
b
b
b
b
b
b
d
c
c
c
c
c
k
c
f
m
c
b
b
b
c
c
e
b
b
b
b
a
"}
(6,1,1) = {"
s
u
u
w
w
w
w
w
u
u
x
x
x
x
x
x
x
x
x
x
x
x
y
y
y
y
F
F
F
F
F
F
F
F
u
a
b
b
d
c
f
c
b
b
b
b
b
c
c
c
c
c
c
c
b
b
c
n
b
b
b
c
c
c
c
b
b
b
b
a
"}
(7,1,1) = {"
s
u
w
w
w
w
w
w
w
u
u
x
x
x
x
x
x
x
x
x
x
x
y
y
x
z
z
z
z
F
F
F
F
F
u
a
b
b
b
b
c
c
c
b
b
b
b
c
c
b
c
b
b
b
b
b
h
b
b
b
b
d
c
c
f
c
b
b
b
a
"}
(8,1,1) = {"
s
u
w
w
w
w
w
w
w
u
u
z
z
x
x
x
x
x
x
x
x
x
x
x
x
z
z
z
z
F
F
F
F
F
u
a
b
b
b
b
b
c
c
c
c
c
c
c
c
b
b
b
b
b
b
b
b
b
b
b
c
c
c
c
c
c
c
b
b
a
"}
(9,1,1) = {"
s
u
w
w
w
w
w
w
w
u
u
z
z
x
x
x
x
x
x
x
x
x
x
x
x
z
z
z
z
z
F
F
F
F
u
a
b
b
b
b
b
b
c
c
c
c
c
c
f
b
b
b
b
b
b
b
b
b
b
b
c
c
c
j
c
c
c
b
b
a
"}
(10,1,1) = {"
s
u
w
w
w
w
w
w
w
w
z
z
z
z
z
x
x
x
x
x
x
x
x
x
x
x
x
x
z
z
x
F
F
F
u
a
b
b
b
b
b
b
k
e
b
b
b
b
c
b
b
b
c
c
c
c
c
b
b
c
f
o
c
c
c
c
c
b
b
a
"}
(11,1,1) = {"
s
u
w
w
w
w
w
w
u
u
z
z
z
z
z
z
z
x
x
x
x
x
x
x
x
x
z
z
z
z
z
x
F
F
u
a
b
b
b
b
b
b
b
b
b
b
b
b
c
b
b
b
c
c
c
d
c
b
b
d
c
c
c
f
c
m
b
b
b
a
"}
(12,1,1) = {"
s
u
u
u
w
w
w
u
u
u
y
y
y
y
z
z
z
z
x
x
x
x
x
x
x
z
z
z
z
z
z
z
F
F
u
a
b
b
b
b
b
c
b
b
b
b
b
c
c
b
b
c
c
f
c
c
b
b
b
b
b
c
c
c
c
c
b
b
b
a
"}
(13,1,1) = {"
s
u
u
u
u
u
u
u
u
u
y
y
y
y
z
z
z
z
x
x
x
x
z
z
z
z
z
x
z
z
z
z
F
F
u
a
b
b
b
b
b
c
b
b
c
c
k
c
c
b
b
c
c
c
c
b
b
b
b
b
b
b
k
c
c
b
b
b
b
a
"}
(14,1,1) = {"
s
u
u
u
u
u
u
u
u
y
y
y
y
y
y
y
z
z
z
z
z
z
z
z
z
z
x
x
x
x
z
z
z
F
u
a
b
b
b
c
c
c
c
c
c
c
c
c
c
c
c
c
c
c
c
c
b
c
c
e
b
b
c
c
c
b
b
b
b
a
"}
(15,1,1) = {"
s
u
x
x
u
u
x
x
x
y
y
y
y
y
y
y
z
z
z
z
z
z
z
x
x
x
x
x
x
x
z
z
z
u
u
a
b
b
c
c
c
c
c
c
c
c
c
e
c
c
c
c
b
b
c
c
b
c
d
c
b
b
b
h
c
b
b
b
b
a
"}
(16,1,1) = {"
s
u
x
x
x
x
y
y
y
y
y
y
y
y
y
z
z
z
x
x
x
x
x
x
x
x
x
x
x
x
x
x
x
u
u
a
b
b
c
c
j
c
c
l
c
c
b
b
b
c
c
c
b
b
c
c
b
b
c
c
c
b
b
c
c
f
c
b
b
a
"}
(17,1,1) = {"
s
u
x
x
x
y
y
y
y
y
y
y
y
y
z
z
z
y
x
x
x
x
x
x
x
x
x
x
x
y
y
y
u
u
u
a
b
c
c
c
c
c
c
b
b
b
b
b
b
b
c
c
c
b
d
c
b
b
c
l
c
b
b
b
c
c
c
b
b
a
"}
(18,1,1) = {"
s
u
x
x
x
y
y
y
y
y
y
y
y
y
z
z
z
y
y
y
x
x
x
x
x
x
x
x
x
y
y
y
u
u
u
a
b
c
c
c
f
b
b
b
b
b
b
b
b
b
b
c
c
b
b
b
b
b
c
c
c
b
b
b
c
c
c
b
b
a
"}
(19,1,1) = {"
s
u
y
y
y
y
y
y
y
y
y
y
y
y
z
z
z
y
y
y
x
x
x
x
x
x
x
x
x
y
y
y
y
u
u
a
b
d
c
c
b
b
b
c
c
c
c
b
b
b
b
c
c
b
b
b
b
b
c
c
c
b
b
b
c
c
e
b
b
a
"}
(20,1,1) = {"
s
u
y
y
y
y
y
y
y
y
y
z
z
z
z
z
z
y
y
y
y
x
x
x
x
x
x
x
x
y
y
y
y
u
u
a
b
c
c
c
b
b
c
c
c
c
c
b
b
b
b
c
c
c
b
b
b
b
c
k
c
b
b
b
o
c
c
b
b
a
"}
(21,1,1) = {"
s
u
y
y
y
y
y
y
y
y
y
z
z
z
z
z
y
y
y
y
y
x
x
x
x
x
x
x
x
y
y
y
y
y
u
a
b
c
c
c
b
b
c
c
j
c
c
b
b
b
b
h
c
c
b
b
b
b
d
c
c
c
c
c
c
c
c
b
b
a
"}
(22,1,1) = {"
s
u
y
y
y
y
y
y
y
y
z
x
z
z
z
z
y
y
y
y
y
x
x
x
x
x
x
x
x
y
y
y
y
y
u
a
b
c
c
b
b
b
c
c
c
c
c
c
b
b
b
c
c
c
b
b
b
b
b
c
c
c
c
c
c
c
b
b
b
a
"}
(23,1,1) = {"
s
u
u
y
y
y
y
y
y
x
z
x
z
z
z
z
y
y
y
y
y
x
x
x
x
x
x
y
y
y
y
y
y
y
u
a
b
c
c
b
b
b
c
c
b
b
c
c
b
b
b
b
c
c
b
b
b
b
b
c
c
c
c
c
c
c
b
b
b
a
"}
(24,1,1) = {"
s
u
u
y
y
y
y
y
y
x
x
x
z
z
z
z
z
y
y
y
y
x
x
x
x
x
x
y
y
y
y
y
y
y
u
a
b
c
c
b
b
b
c
c
b
b
c
c
c
b
b
b
c
c
b
b
b
b
b
c
e
c
f
b
b
b
b
b
b
a
"}
(25,1,1) = {"
s
u
u
y
y
y
y
y
y
x
x
x
z
z
z
z
z
y
y
y
y
y
y
x
x
x
x
y
y
y
y
y
y
y
u
a
b
c
c
b
b
b
c
b
b
b
b
c
c
b
b
b
c
c
b
b
b
b
b
c
o
c
c
b
b
b
b
b
b
a
"}
(26,1,1) = {"
s
u
u
y
y
y
y
y
y
x
x
x
z
z
z
z
z
y
y
y
y
y
y
x
x
x
x
y
y
y
y
y
y
y
u
a
b
e
c
b
b
b
c
b
b
b
b
b
c
b
b
c
c
c
c
b
b
b
b
c
c
c
b
b
b
b
c
b
b
a
"}
(27,1,1) = {"
s
u
u
u
y
y
y
y
y
x
x
z
z
z
z
z
z
y
y
y
y
y
y
x
x
x
x
y
y
y
y
y
y
y
u
a
b
c
c
b
b
c
c
b
b
b
b
b
c
b
b
c
c
c
c
b
b
b
b
c
c
b
b
b
d
c
o
q
b
a
"}
(28,1,1) = {"
s
u
u
u
x
x
x
x
x
x
x
z
z
z
z
y
y
y
y
y
y
y
y
x
x
x
x
y
y
y
y
y
y
y
u
a
b
c
c
b
b
b
c
l
b
b
b
b
c
b
b
c
c
c
c
d
b
b
c
o
c
b
b
b
c
j
c
r
b
a
"}
(29,1,1) = {"
s
u
u
u
x
x
x
x
x
x
x
z
z
z
z
y
y
y
y
y
y
y
y
y
x
x
x
x
x
x
y
y
y
y
u
a
b
c
c
b
b
b
c
c
b
b
b
b
c
b
b
b
c
j
c
f
b
b
h
c
c
b
b
b
o
c
c
t
b
a
"}
(30,1,1) = {"
s
u
u
u
u
u
x
x
x
x
x
z
z
z
z
y
y
y
y
y
y
y
y
y
x
x
x
x
x
x
y
y
y
y
u
a
b
c
c
c
b
b
c
c
b
b
b
b
c
c
b
b
c
c
c
c
b
b
c
c
c
b
b
b
c
p
c
b
b
a
"}
(31,1,1) = {"
s
u
u
u
u
u
x
x
x
x
z
z
z
z
y
y
y
y
y
y
y
y
y
y
x
x
x
x
x
x
x
x
x
y
u
a
b
c
c
c
b
b
c
c
b
b
b
c
c
c
b
b
c
c
c
c
b
b
c
c
c
b
b
c
c
c
c
b
b
a
"}
(32,1,1) = {"
s
u
u
u
u
u
x
x
x
x
z
z
z
z
y
y
y
y
y
y
y
y
y
y
x
x
x
x
x
x
x
x
x
y
u
a
b
f
c
c
b
b
c
c
b
b
b
b
k
c
b
b
d
c
c
b
b
b
c
c
b
b
b
e
c
c
c
b
b
a
"}
(33,1,1) = {"
s
u
u
u
u
u
u
x
x
x
z
z
z
z
y
y
y
y
y
y
y
y
y
y
x
x
x
x
x
x
x
x
x
y
u
a
b
c
c
c
b
b
c
c
c
b
b
b
b
c
c
b
b
b
c
b
b
b
c
c
b
b
d
c
c
c
b
b
b
a
"}
(34,1,1) = {"
s
u
u
u
u
u
u
x
x
x
z
z
x
z
z
z
y
y
y
y
y
y
y
x
x
x
x
x
x
x
x
x
x
y
u
a
b
c
c
c
b
b
d
c
c
c
b
b
b
f
c
b
b
b
b
b
b
c
c
c
c
c
o
c
c
c
b
b
b
a
"}
(35,1,1) = {"
s
u
u
u
u
u
u
u
x
x
z
z
z
x
z
z
y
y
y
y
y
y
y
x
x
x
x
x
x
x
x
x
x
x
u
a
b
c
c
c
b
b
b
b
c
c
b
b
b
c
c
b
b
b
b
b
b
c
c
c
c
c
c
c
c
b
b
b
b
a
"}
(36,1,1) = {"
s
u
u
u
u
u
x
u
u
z
z
z
z
x
x
y
y
y
y
y
y
y
y
x
x
x
x
x
x
x
x
x
x
x
u
a
b
b
c
c
c
b
b
b
c
c
b
b
b
c
c
c
c
c
b
b
b
c
l
c
c
c
c
c
b
b
b
b
b
a
"}
(37,1,1) = {"
s
u
u
u
x
x
x
x
u
z
z
z
x
x
x
y
y
y
y
y
y
y
y
x
x
x
x
x
x
x
x
x
x
x
u
a
b
b
c
c
k
b
b
b
c
c
b
b
b
b
b
b
c
c
b
b
b
f
c
c
c
c
b
b
b
b
b
b
b
a
"}
(38,1,1) = {"
s
u
u
x
z
C
z
z
z
z
z
z
x
x
x
x
x
y
y
y
y
u
u
u
y
x
x
x
x
x
x
x
x
x
u
a
b
b
c
c
c
c
b
m
c
c
c
b
b
b
b
b
h
f
c
c
c
c
c
c
b
b
b
b
b
b
b
b
b
a
"}
(39,1,1) = {"
s
u
x
x
z
z
z
z
z
z
z
x
x
x
x
x
x
y
y
y
y
u
u
y
y
x
x
x
x
x
x
x
x
x
u
a
b
b
d
c
c
c
c
c
c
c
c
b
b
b
b
b
b
c
c
c
c
c
d
c
b
b
b
b
b
b
b
b
b
a
"}
(40,1,1) = {"
s
u
x
x
z
z
z
z
z
u
x
x
x
x
x
x
x
y
y
u
u
u
u
u
u
y
y
y
y
x
x
x
x
u
u
a
b
b
g
c
c
j
c
f
c
e
c
b
b
b
c
b
b
c
l
e
c
c
c
b
b
b
b
b
b
b
b
b
b
a
"}
(41,1,1) = {"
s
u
u
z
B
z
E
z
u
u
x
x
x
x
x
x
x
y
y
u
u
u
u
u
u
y
y
y
y
x
x
x
x
u
u
a
b
b
c
c
h
c
c
c
c
c
c
c
c
c
c
c
c
c
d
c
c
c
b
b
b
b
b
b
b
b
b
b
b
a
"}
(42,1,1) = {"
s
u
u
z
z
z
z
z
u
u
x
x
x
x
x
x
y
y
y
y
y
u
u
u
u
y
y
y
y
x
x
x
x
u
u
a
b
b
b
b
c
c
c
c
c
c
c
c
f
c
c
c
c
c
c
c
c
b
b
b
b
b
b
b
b
b
b
b
b
a
"}
(43,1,1) = {"
s
u
u
u
z
D
z
u
u
u
x
x
x
x
x
x
y
y
y
y
y
u
u
u
u
u
y
y
y
x
x
x
u
u
u
a
b
b
b
b
b
b
b
b
b
b
b
d
c
c
c
c
b
b
b
b
b
b
b
b
b
b
b
b
b
b
b
b
b
a
"}
(44,1,1) = {"
s
u
u
u
u
u
u
u
u
u
u
u
u
u
u
u
u
u
u
u
u
u
u
u
u
u
u
u
u
u
u
u
u
u
u
a
b
b
b
b
b
b
b
b
b
b
b
b
b
b
b
b
b
b
b
b
b
b
b
b
b
b
b
b
b
b
b
b
b
a
"}
(45,1,1) = {"
s
s
s
s
s
s
s
s
s
s
s
s
s
s
s
s
s
s
s
s
s
s
s
s
s
s
s
s
s
s
s
s
s
s
s
a
a
a
a
a
a
a
a
a
a
a
a
a
a
a
a
a
a
a
a
a
a
a
a
a
a
a
a
a
a
a
a
a
a
a
"}
